{
	"99":
	[
		[0,0,0,0,0,1,0,0,0,0,0],
		[0,2,2,2,2,2,2,2,2,2,0],
		[0,2,2,2,2,2,5,2,2,2,0],
		[0,5,2,2,2,2,2,2,2,2,0],
		[0,2,2,2,2,7,2,2,5,2,0],
		[0,2,2,2,2,5,2,2,2,2,0],
		[0,2,2,2,2,2,2,2,2,2,0],
		[0,2,5,2,2,2,2,2,2,2,0],
		[0,0,0,0,0,0,0,0,0,0,0]
	],
	"98":
	[
		[0,0,0,0,0,1,0,0,0,0,0],
		[0,2,2,2,2,2,2,2,2,2,0],
		[0,2,2,5,2,2,2,2,5,2,0],
		[0,2,2,2,2,2,2,2,2,2,0],
		[0,2,2,2,2,7,2,5,2,2,0],
		[0,2,5,2,2,2,2,2,2,2,0],
		[0,2,2,2,2,2,2,2,2,2,0],
		[0,2,2,2,2,2,5,2,2,2,0],
		[0,0,0,0,0,0,0,0,0,0,0]
	],
	"97":
	[
		[0,0,0,0,0,0,0,0,0,0,0],
		[0,4,4,4,4,4,4,4,4,4,0],
		[0,4,4,4,4,4,4,4,4,4,0],
		[0,4,4,4,2,2,2,4,4,4,0],
		[0,4,4,2,2,2,2,2,4,4,0],
		[0,4,4,2,2,6,2,2,4,4,0],
		[0,4,4,2,2,2,2,2,4,4,0],
		[0,4,4,4,2,7,2,4,4,4,0],
		[0,0,0,0,0,8,0,0,0,0,0]
	],
	"96":
	[
		[0,0,0,0,0,0,0,0,0,0,0],
		[0,4,4,4,4,4,4,4,4,4,0],
		[0,4,4,4,4,4,4,4,4,4,0],
		[0,4,4,4,2,2,2,4,4,4,0],
		[0,4,2,2,2,2,2,2,2,4,0],
		[0,4,4,2,2,6,2,2,4,4,0],
		[0,4,4,2,2,2,2,2,4,4,0],
		[0,4,4,4,2,7,2,4,4,4,0],
		[0,0,0,0,0,8,0,0,0,0,0]
		]
}